11111111111111111111
1600Y000900000_~===1
100015000ZS001_Y===1
11~111100SZ001_1===1
1001/000000001_1===#
100100000Y/001(<1Y11
100100)}0~005-0____1
100100({0~000-0_%|_1
100Y000001\00Y0_|%_1
100~000001100-0____1
11111111111Y111~1111
1%______|1%________1
1_{0050(_~_{0500(__1
1_01==10_~_000000_%0
1_0====0_Y\}0000)_|0
Y_01==10_1X________1
1_40==0J_11__%##|__1
1_}0==0)_X1__1001__1
#___==__%11|_1000\/1
1111##11111111\00001
