1111111111111111111111111111111111111111
1000Y000000000_~===116_YY00_==========91
1000Y000000000_~===116______=======11111
11~111100SZ001_1===1%|=========####T0001
1001/000000001_1===#|%1111A1111#11100001
100100000Y/001(<1Y11*******************1
100100)}0~005-00000000000000000000000001
100100({0~000-0_%|_000000000000000000001
100Y000001\00Y0_|%_100000000%|0000000001
100~0+++01100-0____100000000|%0000000001
11111111111Y111~111100000000000000000001
1%______|1%_________00000000000000000001
1_{0050(_~_{0500(__1000000+++00000000001
1_01==10_~_000000_%000000000000000000001
1_0====0_Y\}0000)_|000000000000000000001
Y_01==10_1X________100000000000000000001
1_00==0J_11__%##|__100000000000000000001
1_}0==0)_X1__1001__100000000000000)}0001
#___==__%11|_1000\/100000000000000({0001
1111##11111111\0000001111111011111111111
1111111111111111110001111111011111111111
1000Y000000000_~===11600Y000000000_~===1
1600Y000000000_~===11600Y000000000_~===1
11~111100SZ001_1===100000000000000000001
1001/000000001_1===#00000000000000000001
100100000Y/001(<1Y1100000000000++++00001
100100)}0~005-0____100000000000000000001
100100({0~000-0_%|_000000000000000000001
100Y000001\00Y0_|%_100000000%|0000000001
100~0+++01100-0____100000000|%0000000001
11111111111Y111~111100000000000000000001
1%______|1%_________00000000000000000001
1_{0050(_#_{0500(__100000000000000000001
1_01==10##_000000_%000000000000000000001
1_u====0#Y\}0000)_|000000000000000000001
Yu01==10T1X________100000000000000000001
1u4t==00A11__%##|__100000000000000000001
1uu0==0)_X1__1001__100000000000000)}0001
#***==__%11|_1000\/100000000000000({0001
1111##11111111\0000111111111111111111111
