1111111111111111111111111111111111111111
1=========================10000000100001
1=========================10000000100001
1=========================00000000A00001
1=========================10000000100001
1=========================10000000100001
1=================1111111111111111100001
1=================1000000000000000000001
1=================1000000000000000000001
1=================1000000000000000000001
111111=11111111=111000000000000000000001
100000_00000#000001000000000000000000001
10000__00000#000001000000000000000000001
10000_000000#000009000000000000000000001
11111=1111111000001000000000000000000001
1===========1000001000000000000000000001
1===========1000001000000000000000000001
1===========1000001000000000000000000001
1===========10000010000000%111#111000001
1===========1000001000000010000001000001
1===========1000001000000010000001000001
1===========10000010000000|000000%000001
1===========1111111111111111111111111111
1===============100000000000000000000001
1===============100000000000000000000001
1===============1===00000000000000000001
1===============1===00000000000000000001
1===================00000000____00000001
1===================00000000____00000001
1===================00000000____00000001
1===============1===00000000000000000001
1===============1===00000000000000000001
1===============100000000000000000000001
1===============100000000000000000000001
1===============100000000000000000000001
1111111111111111100000000000000000000001
1===100000000000000000000000000004000001
1===#00000000000000000000000000000000001
1===100000000000000000000000000000000001
111111111111111111111111111111111###1111
