11111111111111111111
19001000000000111111
10500000010000000111
11111000010000110111
10000011110050110111
10000000010000110111
10000000010111110111
10000000016000110111
10000000010000110111
11111111111111110111
11111111111111110111
10601000000000110111
10000000010000110111
11111000010500000111
10000011110000111111
10000000010000000001
10000000010111110001
12300005010000110001
1*400000010000000501
11111111111111111111
