1111111=11111111111111111EERRRRRRRRRRRRR
1/===\1#1/==\111111111111##R11111111111R
1============111111111111==111111111111R
1==/\====/\==1111111RRRRR##RRRRRRRRRRR=R
1==\/====\/==1=1====#===========#====R=R
1============1======#=/\====/\==#====R=R
1==/\====/\==1=1====#=\/====\/==#====R=R
1==\/====\/==1=11111#=====4=====#1111R=R
1===========/1=1====#===========#====R=R
1==11111111111=1====#=====I=====#====R=R
1==\/=======\1=1====#=/\====/\==#====R=R
1============1=1====#=\/====\/==#====R=R
1\=====/1\===1=11111#===========#1111R=R
1111==/111\=/1=1====#==/11#11\==#====R=R
1111==\/==\111=1====#=/11/=\11\=#====R=R
11/\\======\11=1====#=1=======1=#====R=R
1/==\1=======1=111111=~=/1~1\=~=R1111R=R
1====~=======1=\111111111/=\111RRRRRRR1R
1====1======/1===#==========11=T1111111R
1====1\====/11=1111111111===/\==1111111R
1====11====111==========1===\/==1111111R
1====11====\11====11111=1=======1111111R
1====11\=====#====11111=111111111111111R
1======1\==/11====111/==1/========\1===R
1====1111==111####111==/1===/\=====1===R
1====1=====\1IOOOO#====1/===\/=====1===R
1\==/1=======OAAAAI11==~===========1===R
11##11==11\==OAAAAI11=/1===========1===R
119911==111\=OAAAAO===1/===========1===R
11111/==\1111IAAAAI11=1============1===R
1111/====\11OOAAAAI11=1======y=====1===R
111/======1/OAAAAAO=1=1=/\======/\=1===R
111=======1=OAAAAAO/1=1=\/======\/=1===R
111=========OAAAAAO\1=1============1===R
111=======1=OAAAAAO=1=1============1===R
111=======11OAAAAAO===1=====/\=====1===R
111=======RTOAAAAAO=1=1=====\/=====1===R
111\=====/RIIAAAAAI1111\==========/1111R
1111\===/1R11IIIII111111111111111111111R
1111111111RRRRRRRRRRRRRRRRRRRRRRRRRRRRRR
