1111111111111111111111111111111111111111
1______________________________=1======1
1_00000000000000000000000000___=1======1
1_00000000000000000000000000___=#======1
1_00000000000000000000000000___=1======1
1_000__________________________=1======1
1_000_1111111111111111111111111111111111
1_000_1000000000000000000000000000000001
1_000_10-0-0-0-0-00___00-0-0-0-00-000001
1_000_10-0-0-0-0-00___00-0-0-0-00-000001
1_000_10-0-0-0-0-00___00-0-0-0-00-000001
I_000_1000000000000___000000000000000001
I_____1___________________________0---01
#__4__~___________________________000001
I_____1___________________________0---01
I_____1000IIIIIAAI0__000000000____000001
1_____1000III1OOOO-__0-0-0-0-0____0---01
1111111000III1OOOO-__0-0-0-0-0____000001
1000000000IIIIIAAI0__0-0-0-0-0____0---01
1000000000000000000__111111111____000001
10--0_____________________________0---01
10000_____________________________000001
10--0_____________________________0---01
10000___10000000000000000000000000000001
10--0___1---00-0-00-0-0-0011111111000001
10000___1---00-0-00-0-0-001======1000001
10--0___1---00-0-00-0-0-00111#1111000001
10000___100000000000000000000_0000000001
10--0_____________________________000001
10000_____________________________0---01
10--0_____________________________000001
10000_____________________________0---01
10--0_____________________________000001
10000___________A_________________0---01
10000000000000'IAI'I'II__000000000000001
10000000000000I=O191=R'__000000000000001
10000000000000I==1=1=R'__000000000000001
10000000000000IJT====##__000000000000001
10000000000000I=#====RI__000000000000001
1#############I1RRRRRRI################1
