1111111111111111111111111111111111111111
1=======================================
1=11111111111111111111111111111111111111
1=1-----------------------------------91
1=1------------------------------------1
1=1-111111111111111111111111111111111111
1=1-1======TA----------------A-----A-1-1
1=1-1======T1****************1=====1-1-1
1=1-1======T1****************1=====1---1
1=1-1======T#****************#=====1---1
1=1-1=======#****************#=====111-1
1=1-1=======1****************1=======1-1
1=1-1=======1*KKKKK*****KKKK*1=======1=1
1=1-1=1=====1****************1=========1
1=1-1=1=====1*KKKKK*****KKKK*1=========1
1=1-1=1=====1****************1=====6===1
1=1-1=1=====1*KKKKK*****KKKK*1=========1
1=1-1-1=====1****************1=========9
1=1-1-1=====1*KKKKK*****KKKK*1=====11111
1=1---1=====1****************1=====10000
1=1---1=====1*KKKKK*****KKKK*1=====10000
1=1---1=====1****************1=====10000
1#11111111111111111~~~~~1111111111111111
1400000000000000000=====0000#-----------
1000000000000000000=====0000#-----------
1000000000000000000=====0000#-----------
1000000000000000000000000000#-----------
10000000000000000000000000001111111111--
1000000000000000000000000000A000101001--
10000000000000000000000000001010101001--
10000000000000000000000000001010101T0A--
100000000000____0000000000001010101T01--
100G00000000_/\_000000000G001010101T01--
#00000000000_\/_00000000000010101#1T01--
#00000000000____00000000000010111TTT01--
#00000000000000000000000000011111#1111--
#000000000000000000000000000#-----------
10000000000000e0000000000000#-----------
1000000000000000000000000000#-----------
1111111111111111111111111111111111111111
