111111111111111111111111111111111111111111111111111111111111111111111111111111111111111111111111111111111111111111111111
1600|0009110000~00011600|0009110000~00011600|0009110000~00011600|0009110000~00011600|0009110000~00011600|0009110000~0001
100015000110011|5001100015000110011|5001100015000110011|5001100015000110011|5001100015000110011|5001100015000110011|5001
100000000000000000000000000000000000000000000000000000000000000000000000000000000000000000000000000000000000000000000001
1001/00001100101000#1001/00001100101000#1001/00001100101000#1001/00001100101000#1001/00001100101000#1001/00001100101000#
100100000|/0010\1|11100100000|/0010\1|11100100000|/0010\1|11100100000|/0010\1|11100100000|/0010\1|11100100000|/0010\1|11
100100000~0051000001100100000~0051000001100100000~0051000001100100000~0051000001100100000~0051000001100100000~0051000001
100100000~0001005001100100000~0001005001100100000~0001005001100100000~0001005001100100000~0001005001100100000~0001005001
100|000001\00|000001100|000001\00|000001100|000001\00|000001100|000001\00|000001100|000001\00|000001100|000001\00|000001
100~0000011000000001100~0000011000000001100~0000011000000001100~0000011000000001100~0000011000000001100~0000011000000001
11111111111|111~111111111111111|111~111111111110111|111~111111111111111|111~111111111111111|111~111111111111111|111~1111
1/000000\1/0000000011/000000\1/0000000011/000000\1/0000000011/000000\1/0000000011/000000\1/0000000011/000000\1/000000001
100000000000000000000000000000000000000000000000000000000000000000000000000000000000000000000000000000000000000000000001
1001==100~00000500/01001==100~00000500/01001==100~00000500/01001==100~00000500/01001==100~00000500/01001==100~00000500/0
100====00|\0000000\0100====00|\0000000\0100====00|\0000000\0100====00|\0000000\0100====00|\0000000\0100====00|\0000000\0
|001==1001X005000001|001==1001X005000001|001==1001X005000001|001==1001X005000001|001==1001X005000001|001==1001X005000001
1000000001100/##\0011000000001100/##\0011000000001100/##\0011000000001100/##\0011000000001100/##\0011000000001100/##\001
10_000-00X100100100110_000-00X100100100110_000-00X100100100110_000-00X100100100110_000-00X100100100110_000-00X1001001001
#0004000/11\01000\/1#0000000/11\01000\/1#0000000/11\01000\/1#0000000/11\01000\/1#0000000/11\01000\/1#0000000/11\01000\/1
1001#101111111\000011111#111111111\000011111#110111111\000011111#111111111\000011111#111111111\000011111#111111111\00001
110111011111111101111111111111111111011111111110111111111111111111111111111111111111111111111111111111111111111111111111
1600|0009110000~00011600|0009110000~00011600|0009110000~00011600|0009110000~00011600|0009110000~00011600|0009110000~0001
100015000110011|5001100015000110011|5001100015000110011|5001100015000110011|5001100015000110011|5001100015000110011|5001
100000000000000000000000000000000000000000000000000000000000000000000000000000000000000000000000000000000000000000000001
1001/00001100101000#1001/00001100101000#1001/00001100101000#1001/00001100101000#1001/00001100101000#1001/00001100101000#
100100000|/0010\1|11100100000|/0010\1|11100100000|/0010\1|11100100000|/0010\1|11100100000|/0010\1|11100100000|/0010\1|11
100100000~0051000001100100000~0051000001100100000~0051000001100100000~0051000001100100000~0051000001100100000~0051000001
100100000~0001005001100100000~0001005001100100000~0001005001100100000~0001005001100100000~0001005001100100000~0001005001
100|000001\00|000001100|000001\00|000001100|000001\00|000001100|000001\00|000001100|000001\00|000001100|000001\00|000001
100~0000011000000001100~0000011000000001100~0000011000000001100~0000011000000001100~0000011000000001100~0000011000000001
11111011111|111~111111111111111|111~111111111110111|111~111111111111111|111~111111111111111|111~111111111111111|111~1111
1/000000\1/0000000011/000000\1/0000000011/000000\1/0000000011/000000\1/0000000011/000000\1/0000000011/000000\1/000000001
100000050~0005000001100000050~0005000001100000050~0005000001100000050~0005000001100000050~0005000001100000050~0005000001
1001==100~00000500/01001==100~00000500/01001==100~00000500/01001==100~00000500/01001==100~00000500/01001==100~00000500/0
100====00|\0000000\0100====00|\0000000\0100====00|\0000000\0100====00|\0000000\0100====00|\0000000\0100====00|\0000000\0
100000000000000000000000000000000000000000000000000000000000000000000000000000000000000000000000000000000000000000000001
1000000001100/##\0011000000001100/##\0011000000001100/##\0011000000001100/##\0011000000001100/##\0011000000001100/##\001
10_000-00X100100100110_000-00X100100100110_000-00X100100100110_000-00X100100100110_000-00X100100100110_000-00X1001001001
#0000000/11\01000\/1#0000000/11\01000\/1#0000000/11\01000\/1#0000000/11\01000\/1#0000000/11\01000\/1#0000000/11\01000\/1
1111#111111111\000011111#111111111\000011111#110111111\000011111#111111111\000011111#111111111\000011111#111111111\00001
111111111111111101111111111111111111111111111110111111111111111111111111111111111111111111111111111111111111111111111111
1600|0009110000~00011600|0009110000~00011600|0009110000~00011600|0009110000~00011600|0009110000~00011600|0009110000~0001
100015000110011|5001100015000110011|5001100015000110011|5001100015000110011|5001100015000110011|5001100015000110011|5001
100000000000000000000000000000000000000000000000000000000000000000000000000000000000000000000000000000000000000000000001
1001/00001100101000#1001/00001100101000#1001/00001100101000#1001/00001100101000#1001/00001100101000#1001/00001100101000#
100100000|/0010\1|11100100000|/0010\1|11100100000|/0010\1|11100100000|/0010\1|11100100000|/0010\1|11100100000|/0010\1|11
100100000~0051000001100100000~0051000001100100000~0051000001100100000~0051000001100100000~0051000001100100000~0051000001
100100000~0001005001100100000~0001005001100100000~0001005001100100000~0001005001100100000~0001005001100100000~0001005001
100|000001\00|000001100|000001\00|000001100|000001\00|000001100|000001\00|000001100|000001\00|000001100|000001\00|000001
100~0000011000000001100~0000011000000001100~0000011000000001100~0000011000000001100~0000011000000001100~0000011000000001
11111011111|111~111111111111111|111~111111111110111|111~111111111111111|111~111111111111111|111~111111111111111|111~1111
1/000000\1/0000000011/000000\1/0000000011/000000\1/0000000011/000000\1/0000000011/000000\1/0000000011/000000\1/000000001
100000050~0005000001100000050~0005000001100000050~0005000001100000050~0005000001100000050~0005000001100000050~0005000001
1001==100~00000500/01001==100~00000500/01001==100~00000500/01001==100~00000500/01001==100~00000500/01001==100~00000500/0
100000000000000000000000000000000000000000000000000000000000000000000000000000000000000000000000000000000000000000000001
|001==1001X005000001|001==1001X005000001|001==1001X005000001|001==1001X005000001|001==1001X005000001|001==1001X005000001
1000000001100/##\0011000000001100/##\0011000000001100/##\0011000000001100/##\0011000000001100/##\0011000000001100/##\001
10_000-00X100100100110_000-00X100100100110_000-00X100100100110_000-00X100100100110_000-00X100100100110_000-00X1001001001
#0000000/11\01000\/1#0000000/11\01000\/1#0000000/11\01000\/1#0000000/11\01000\/1#0000000/11\01000\/1#0000000/11\01000\/1
1111#111111111\000011111#111111111\000011111#110111111\000011111#111111111\000011111#111111111\000011111#111111111\00001
111111111111111101111111111111111111111111111110111111111111111111111111111111111111111111111111111111111111111111111111
1600|0009110000~00011600|0009110000~00011600|0009110000~00011600|0009110000~00011600|0009110000~00011600|0009110000~0001
100015000110011|5001100015000110011|5001100015000110011|5001100015000110011|5001100015000110011|5001100015000110011|5001
11~1111001100101000111~1111001100101000111~1111001100101000111~1111001100101000111~1111001100101000111~11110011001010001
1001/00001100101000#1001/00001100101000#1001/00001100101000#1001/00001100101000#1001/00001100101000#1001/00001100101000#
100000000000000000000000000000000000000000000000000000000000000000000000000000000000000000000000000000000000000000000001
100100000~0051000001100100000~0051000001100100000~0051000001100100000~0051000001100100000~0051000001100100000~0051000001
100100000~0001005001100100000~0001005001100100000~0001005001100100000~0001005001100100000~0001005001100100000~0001005001
100|000001\00|000001100|000001\00|000001100|000001\00|000001100|000001\00|000001100|000001\00|000001100|000001\00|000001
100~0000011000000001100~0000011000000001100~0000011000000001100~0000011000000001100~0000011000000001100~0000011000000001
11111011111|111~111111111111111|111~111111111110111|111~111111111111111|111~111111111111111|111~111111111111111|111~1111
1/000000\1/0000000011/000000\1/0000000011/000000\1/0000000011/000000\1/0000000011/000000\1/0000000011/000000\1/000000001
100000050~0005000001100000050~0005000001100000050~0005000001100000050~0005000001100000050~0005000001100000050~0005000001
1001==100~00000500/01001==100~00000500/01001==100~00000500/01001==100~00000500/01001==100~00000500/01001==100~00000500/0
100====00|\0000000\0100====00|\0000000\0100====00|\0000000\0100====00|\0000000\0100====00|\0000000\0100====00|\0000000\0
100000000000000000000000000000000000000000000000000000000000000000000000000000000000000000000000000000000000000000000001
1000000001100/##\0011000000001100/##\0011000000001100/##\0011000000001100/##\0011000000001100/##\0011000000001100/##\001
10_000-00X100100100110_000-00X100100100110_000-00X100100100110_000-00X100100100110_000-00X100100100110_000-00X1001001001
#0000000/11\01000\/1#0000000/11\01000\/1#0000000/11\01000\/1#0000000/11\01000\/1#0000000/11\01000\/1#0000000/11\01000\/1
1111#111111111\000011111#111111111\000011111#110111111\000011111#111111111\000011111#111111111\000011111#111111111\00001
111111111111111101111111111111111111111111111110111111111111111111111111111111111111111111111111111111111111111111111111
1600|0009110000~00011600|0009110000~00011600|0009110000~00011600|0009110000~00011600|0009110000~00011600|0009110000~0001
100015000110011|5001100015000110011|5001100015000110011|5001100015000110011|5001100015000110011|5001100015000110011|5001
11~1111001100101000111~1111001100101000111~1111001100101000111~1111001100101000111~1111001100101000111~11110011001010001
100000000000000000000000000000000000000000000000000000000000000000000000000000000000000000000000000000000000000000000001
100100000|/0010\1|11100100000|/0010\1|11100100000|/0010\1|11100100000|/0010\1|11100100000|/0010\1|11100100000|/0010\1|11
100100000~0051000001100100000~0051000001100100000~0051000001100100000~0051000001100100000~0051000001100100000~0051000001
100100000~0001005001100100000~0001005001100100000~0001005001100100000~0001005001100100000~0001005001100100000~0001005001
100|000001\00|000001100|000001\00|000001100|000001\00|000001100|000001\00|000001100|000001\00|000001100|000001\00|000001
100~0000011000000001100~0000011000000001100~0000011000000001100~0000011000000001100~0000011000000001100~0000011000000001
11111011111|111~111111111111111|111~111111111110111|111~111111111111111|111~111111111111111|111~111111111111111|111~1111
1/000000\1/0000000011/000000\1/0000000011/000000\1/0000000011/000000\1/0000000011/000000\1/0000000011/000000\1/000000001
100000050~0005000001100000050~0005000001100000050~0005000001100000050~0005000001100000050~0005000001100000050~0005000001
1001==100~00000500/01001==100~00000500/01001==100~00000500/01001==100~00000500/01001==100~00000500/01001==100~00000500/0
100====00|\0000000\0100====00|\0000000\0100====00|\0000000\0100====00|\0000000\0100====00|\0000000\0100====00|\0000000\0
|001==1001X005000001|001==1001X005000001|001==1001X005000001|001==1001X005000001|001==1001X005000001|001==1001X005000001
100000000000000000000000000000000000000000000000000000000000000000000000000000000000000000000000000000000000000000000001
10_000-00X100100100110_000-00X100100100110_000-00X100100100110_000-00X100100100110_000-00X100100100110_000-00X1001001001
#0000000/11\01000\/1#0000000/11\01000\/1#0000000/11\01000\/1#0000000/11\01000\/1#0000000/11\01000\/1#0000000/11\01000\/1
1111#111111111\000011111#111111111\000011111#110111111\000011111#111111111\000011111#111111111\000011111#111111111\00001
111111111111111101111111111111111111111111111110111111111111111111111111111111111111111111111111111111111111111111111111
1600|0009110000~00011600|0009110000~00011600|0009110000~00011600|0009110000~00011600|0009110000~00011600|0009110000~0001
100015000110011|5001100015000110011|5001100015000110011|5001100015000110011|5001100015000110011|5001100015000110011|5001
11~1111001100101000111~1111001100101000111~1111001100101000111~1111001100101000111~1111001100101000111~11110011001010001
100000000000000000000000000000000000000000000000000000000000000000000000000000000000000000000000000000000000000000000001
100100000|/0010\1|11100100000|/0010\1|11100100000|/0010\1|11100100000|/0010\1|11100100000|/0010\1|11100100000|/0010\1|11
100100000~0051000001100100000~0051000001100100000~0051000001100100000~0051000001100100000~0051000001100100000~0051000001
100100000~0001005001100100000~0001005001100100000~0001005001100100000~0001005001100100000~0001005001100100000~0001005001
100|000001\00|000001100|000001\00|000001100|000001\00|000001100|000001\00|000001100|000001\00|000001100|000001\00|000001
100000000000000000000000000000000000000000000000000000000000000000000000000000000000000000000000000000000000000000000001
11111011111|111~111111111111111|111~111111111110111|111~111111111111111|111~111111111111111|111~111111111111111|111~1111
1/000000\1/0000000011/000000\1/0000000011/000000\1/0000000011/000000\1/0000000011/000000\1/0000000011/000000\1/000000001
100000050~0005000001100000050~0005000001100000050~0005000001100000050~0005000001100000050~0005000001100000050~0005000001
1001==100~00000500/01001==100~00000500/01001==100~00000500/01001==100~00000500/01001==100~00000500/01001==100~00000500/0
100====00|\0000000\0100====00|\0000000\0100====00|\0000000\0100====00|\0000000\0100====00|\0000000\0100====00|\0000000\0
|001==1001X005000001|001==1001X005000001|001==1001X005000001|001==1001X005000001|001==1001X005000001|001==1001X005000001
100000000000000000000000000000000000000000000000000000000000000000000000000000000000000000000000000000000000000000000001
10_000-00X100100100110_000-00X100100100110_000-00X100100100110_000-00X100100100110_000-00X100100100110_000-00X1001001001
#0000000/11\01000\/1#0000000/11\01000\/1#0000000/11\01000\/1#0000000/11\01000\/1#0000000/11\01000\/1#0000000/11\01000\/1
111111111111111111111111111111111111111111111111111111111111111111111111111111111111111111111111111111111111111111111111
